11111111111111111111111111111111111111111111111111111111111
10000000000000000000000000000000000000000000000000000000001
10101010101010101010101010101010101010101010101010101010101
10000000000000000000000000000000000000000000000000000000001
10101010101010101010101010101010101010101010101010101010101
10000000000000000000000000000000000000000000000000000000001
10101010101010101010101010101010101010101010101010101010101
10000000000000000000000000000000000000000000000000000000001
10101010101010101010101010101010101010101010101010101010101
10000000000000000000000000000000000000000000000000000000001
10101010101010101010101010101010101010101010101010101010101
10000000000000000000000000000000000000000000000000000000001
10101010101010101010101010101010101010101010101010101010101
10000000000000000000000000000000000000000000000000000000001
11111111111111111111111111111111111111111111111111111111111
